###########
###A @ O###
#         #
#         #
###########