###########
####    ###
# O@ A@O  #
#   @O    #
###### ####
###########